03 02 02 02 02 02 02 02 02 02 02 02 02 02 02 04 
01 00 00 00 00 00 00 00 00 00 00 00 00 00 00 01 
01 00 03 02 00 02 01 00 01 00 01 02 02 02 10 01 
01 00 01 00 00 00 00 00 00 00 00 00 00 00 00 01 
01 00 01 00 01 00 01 01 00 01 01 02 00 01 00 01 
00 00 00 00 01 00 01 00 00 00 01 00 00 00 00 00 
01 00 03 02 05 00 01 00 00 00 01 00 01 01 00 01 
01 00 01 00 00 00 01 02 02 02 01 00 01 01 00 01 
01 00 00 00 01 00 01 01 00 00 00 00 00 00 00 01 
01 00 02 02 05 00 00 00 00 01 00 02 02 02 10 01 
01 00 10 00 00 00 03 02 02 03 00 00 00 00 00 01 
06 02 02 02 02 02 02 02 02 02 02 02 02 02 02 05 