3 2 2 2 2 2 2 2 2 2 2 2 2 4 3 2 2 2 2 2 2 2 2 2 2 2 2 4
1 0 0 0 0 0 0 0 0 0 0 0 0 1 1 0 0 0 0 0 0 0 0 0 0 0 0 1
1 0 3 2 2 4 0 3 2 2 2 4 0 1 1 0 3 2 2 2 4 0 3 2 2 4 0 1
1 9 1 2 2 1 0 1 2 2 2 1 0 1 1 0 1 2 2 2 1 0 1 2 2 1 9 1
1 0 6 2 2 5 0 6 2 2 2 5 0 6 5 0 6 2 2 2 5 0 6 2 2 5 0 1
1 0 0 0 0 0 0 0 0 0 0 0 8 0 0 0 0 0 0 0 0 0 0 0 0 0 0 1
1 0 3 2 2 4 0 3 4 0 3 2 2 2 2 2 2 4 0 3 4 0 3 2 2 4 0 1
1 0 6 2 2 5 0 1 1 0 6 2 2 1 1 2 2 5 0 1 1 0 6 2 2 5 0 1
1 0 0 0 0 0 0 1 1 0 0 0 0 1 1 0 0 0 0 1 1 0 0 0 0 0 0 1
6 2 2 2 2 4 0 1 1 2 2 2 0 1 1 0 2 2 2 1 1 0 3 2 2 2 2 5
2 2 2 2 2 1 0 1 1 2 2 2 0 1 1 0 2 2 2 1 1 0 1 2 2 2 2 2
2 2 2 2 2 1 0 1 1 0 0 0 0 0 0 0 0 0 0 1 1 0 1 2 2 2 2 2
2 2 2 2 2 1 0 1 1 0 3 2 2 0 0 2 2 4 0 1 1 0 1 2 2 2 2 2
2 2 2 2 2 5 0 6 5 0 1 0 0 0 0 0 0 1 0 6 5 0 6 2 2 2 2 2
0 0 0 0 0 0 0 0 0 0 1 0 0 0 0 0 0 1 0 0 0 0 0 0 0 0 0 0
2 2 2 2 2 4 0 3 4 0 1 0 0 0 0 0 0 1 0 3 4 0 3 2 2 2 2 2
2 2 2 2 2 1 0 1 1 0 6 2 2 2 2 2 2 5 0 1 1 0 1 2 2 2 2 2
2 2 2 2 2 1 0 1 1 0 0 0 0 0 0 0 0 0 0 1 1 0 1 2 2 2 2 2
2 2 2 2 2 1 0 1 1 0 3 2 2 2 2 2 2 4 0 1 1 0 1 2 2 2 2 2
3 2 2 2 2 5 0 6 5 0 6 2 2 4 3 2 2 5 0 6 5 0 6 2 2 2 2 4
1 0 0 0 0 0 0 0 0 0 0 0 0 1 1 0 0 0 0 0 0 0 0 0 0 0 0 1
1 0 3 2 2 4 0 3 2 2 2 4 0 1 1 0 3 2 2 2 4 0 3 2 2 4 0 1
1 0 6 2 4 1 0 6 2 2 2 5 0 6 5 0 6 2 2 2 5 0 1 3 2 5 0 1
1 0 0 0 1 1 0 0 0 0 0 0 0 0 0 0 0 0 0 0 0 0 1 1 0 0 0 1
6 2 4 0 1 1 0 3 4 0 3 2 2 2 2 2 2 3 0 3 4 0 1 1 0 3 2 5
3 2 5 0 6 5 0 1 1 0 6 2 2 4 3 2 2 5 0 1 1 0 6 5 0 6 2 4
1 0 0 0 0 0 0 1 1 0 0 0 0 1 1 0 0 0 0 1 1 0 0 0 0 0 0 1
1 9 3 2 2 2 2 5 6 2 2 4 0 1 1 0 3 2 2 5 6 2 2 2 2 4 9 1
1 0 6 2 2 2 2 2 2 2 2 5 8 6 5 0 6 2 2 2 2 2 2 2 2 5 0 1
1 0 0 0 0 0 0 0 0 0 0 0 0 0 0 0 0 0 0 0 0 0 0 0 0 0 0 1
6 2 2 2 2 2 2 2 2 2 2 2 2 2 2 2 2 2 2 2 2 2 2 2 2 2 2 5