3 2 2 2 2 2 2 2 2 2 2 2 2 2 2 4
1 0 0 0 0 0 0 0 0 0 0 0 0 0 0 1
1 0 3 2 0 2 1 0 1 0 1 2 2 2 9 1
1 0 1 0 0 0 0 0 0 0 0 0 0 0 0 1
1 0 1 0 1 0 1 1 0 1 1 2 0 1 0 1
0 0 0 0 1 0 1 0 0 0 1 0 0 0 0 0
1 0 3 2 5 0 1 0 0 0 1 0 1 1 0 1
1 0 1 0 0 0 1 2 2 2 1 0 1 1 0 1
1 0 0 0 1 0 1 1 0 0 0 0 0 0 0 1
1 0 2 2 5 0 0 0 0 1 0 2 2 2 9 1
1 0 9 0 0 0 3 2 2 3 0 0 0 0 0 1
6 2 2 2 2 2 2 2 2 2 2 2 2 2 2 5